Page 1
The Language of Flowers by Kate Greenaway
Alphabetical Listing of Flowers and Their Meanings
Abecedary - Volatility
Abatina - Fickleness
Acacia - Friendship
Acacia, Rose or White - Elegance
Acacia, Yellow - Secret love
Acanthus - The fine arts. Artifice
Acalia - Temperance
Achillea Millefolia - War

Page 2
Aconite (Wolfsbane) - Misanthropy
Aconite, Crowfoot - Luster
Adonis, Flos - Sorrowful remembrance
African Marigold - Vulgar minds
Agnus Castus - Coldness. Indifference
Agrimony - Thankfulness. Gratitude
Almond (Common) - Stupidity. Indiscretion
Almond (Flowering) - Hope
Almond, Laurel - Perfidy
Aloe - Grief. Religious superstition
Althea Frutex (Syrian Mallow) - Persuasion
Alyssum (Sweet) - Worth beyond beauty
Amaranth (Globe) - Immortality. Unfading love
Amaranth (Cockscomb) - Foppery. Affectation
Amaryllis - Pride. Timidity. Splendid beauty

Page 3
Ambrosia - Love returned
American Cowslip - Divine beauty
American Elm - Patriotism
American Linden - Matrimony
American Starwort - Welcome to a stranger
Amethyst - Admiration
Anemone (Garden) - Forsaken
Anemone (Meadow) - Sickness
Angelica - Inspiration
Angrec - Royalty
Apple - Temptation
Apple (Blossom) - Preference
Apple, Thorn - Deceitful charms
Apocynum (Dogsbane) - Deceit
Arbor Vitae - Unchanging friendship
Arbutus - Thee only do I love
